############################################################
#                              #        #      #############
############################   #        #                  #
#                 #            #        ################   #
#                 #            ######   #                  #
#                 #      ######         #      #############
###############   #           #         #                  #
#     #                       #         ################   #
#     #                       ####      #                  #
#                                       #      #############
#################################       #                  #
#     #                                 ################   #
#     #    ##########       ############             #### ##
#     #            #####        #            #       #    ##
#     #     ###     #   ####    #         #  #       ####  #
#     #       #            #    #          #    #    #     #
#     ################### ##################    #    # #####
#     #                   ##################     ###       #
#     #   ##################     #   #   #                 #
#     #                        #   #   #                   #
#     ########################################             #
#                                            #             #
#                                                          #
#                              #        #      #############
############################   #        #                  #
#                 #            #        ################   #
#                 #            ######   #                  #
#                 #      ######         #      #############
###############   #           #         #                  #
#     #                       #         ################   #
#     #                       ####      #                  #
#                                       #      #############
#################################       #                  #
#     #                                 ################   #
#     #    ##########       ############             #### ##
#     #            #####        #            #       #    ##
#     #     ###     #   ####    #         #  #       ####  #
#     #       #            #    #          #    #    #     #
#     ################### ##################    #    # #####
#     #                   ##################     ###       #
#     #   ##################     #   #   #                 #
#     #                        #   #   #                   #
#     ########################################             #
#                                            #             #
#                                                          #
#                              #        #      #############
############################   #        #                  #
#                 #            #        ################   #
#                 #            ######   #                  #
#                 #      ######         #      #############
###############   #           #         #                  #
#     #                       #         ################   #
#     #                       ####      #                  #
#                                       #      #############
#################################       #                  #
#     #                                 ################   #
#     #    ##########       ############             #### ##
#     #            #####        #            #       #    ##
#     #     ###     #   ####    #         #  #       ####  #
#     #       #            #    #          #    #    #     #
#     ################### ##################    #    # #####
#     #                   ##################     ###       #
#     #   ##################     #   #   #                 #
#     #                        #   #   #                   #
#     ########################################             #
#                                            #             #
#                                                          #
#                              #        #      #############
############################   #        #                  #
#                 #            #        ################   #
#                 #            ######   #                  #
#                 #      ######         #      #############
###############   #           #         #                  #
#     #                       #         ################   #
#     #                       ####      #                  #
#                                       #      #############
#################################       #                  #
#     #                                 ################   #
#     #    ##########       ############             #### ##
#     #            #####        #            #       #    ##
#     #     ###     #   ####    #         #  #       ####  #
#     #       #            #    #          #    #    #     #
#     ################### ##################    #    # #####
#     #                   ##################     ###       #
#     #   ##################     #   #   #                 #
#     #                        #   #   #                   #
#     ########################################             #
#                                            #             #
#                                                          #
#                              #        #      #############
############################   #        #                  #
#                 #            #        ################   #
#                 #            ######   #                  #
#                 #      ######         #      #############
###############   #           #         #                  #
#     #                       #         ################   #
#     #                       ####      #                  #
#                                       #      #############
#################################       #                  #
#     #                                 ################   #
#     #    ##########       ############             #### ##
#     #            #####        #            #       #    ##
#     #     ###     #   ####    #         #  #       ####  #
#     #       #            #    #          #    #    #     #
#     ################### ##################    #    # #####
#     #                   ##################     ###       #
#     #   ##################     #   #   #                 #
#     #                        #   #   #                   #
#     ########################################             #
#                                            #             #
#                                                          #
#                              #        #      #############
############################   #        #                  #
#                 #            #        ################   #
#                 #            ######   #                  #
#                 #      ######         #      #############
###############   #           #         #                  #
#     #                       #         ################   #
#     #                       ####      #                  #
#                                       #      #############
#################################       #                  #
#     #                                 ################   #
#     #    ##########       ############             #### ##
#     #            #####        #            #       #    ##
#     #     ###     #   ####    #         #  #       ####  #
#     #       #            #    #          #    #    #     #
#     ################### ##################    #    # #####
#     #                   ##################     ###       #
#     #   ##################     #   #   #                 #
#     #                        #   #   #                   #
#     ########################################             #
#                                            #             #
#                                                          #
#                              #        #      #############
############################   #        #                  #
#                 #            #        ################   #
#                 #            ######   #                  #
#                 #      ######         #      #############
###############   #           #         #                  #
#     #                       #         ################   #
#     #                       ####      #                  #
#                                       #      #############
#################################       #                  #
#     #                                 ################   #
#     #    ##########       ############             #### ##
#     #            #####        #            #       #    ##
#     #     ###     #   ####    #         #  #       ####  #
#     #       #            #    #          #    #    #     #
#     ################### ##################    #    # #####
#     #                   ##################     ###       #
#     #   ##################     #   #   #                 #
#     #                        #   #   #                   #
#     ########################################             #
#                                            #             #
#                                                          #
#                              #        #      #############
############################   #        #                  #
#                 #            #        ################   #
#                 #            ######   #                  #
#                 #      ######         #      #############
###############   #           #         #                  #
#     #                       #         ################   #
#     #                       ####      #                  #
#                                       #      #############
#################################       #                  #
#     #                                 ################   #
#     #    ##########       ############             #### ##
#     #            #####        #            #       #    ##
#     #     ###     #   ####    #         #  #       ####  #
#     #       #            #    #          #    #    #     #
#     ################### ##################    #    # #####
#     #                   ##################     ###       #
#     #   ##################     #   #   #                 #
#     #                        #   #   #                   #
#     ########################################             #
#                                            #             #
#                                                          #
#                              #        #      #############
############################   #        #                  #
#                 #            #        ################   #
#                 #            ######   #                  #
#                 #      ######         #      #############
###############   #           #         #                  #
#     #                       #         ################   #
#     #                       ####      #                  #
#                                       #      #############
#################################       #                  #
#     #                                 ################   #
#     #    ##########       ############             #### ##
#     #            #####        #            #       #    ##
#     #     ###     #   ####    #         #  #       ####  #
#     #       #            #    #          #    #    #     #
#     ################### ##################    #    # #####
#     #                   ##################     ###       #
#     #   ##################     #   #   #                 #
#     #                        #   #   #                   #
#     ########################################             #
#                                            #             #
#                                                          #
#                              #        #      #############
############################   #        #                  #
#                 #            #        ################   #
#                 #            ######   #                  #
#                 #      ######         #      #############
###############   #           #         #                  #
#     #                       #         ################   #
#     #                       ####      #                  #
#                                       #      #############
#################################       #                  #
#     #                                 ################   #
#     #    ##########       ############             #### ##
#     #            #####        #            #       #    ##
#     #     ###     #   ####    #         #  #       ####  #
#     #       #            #    #          #    #    #     #
#     ################### ##################    #    # #####
#     #                   ##################     ###       #
#     #   ##################     #   #   #                 #
#     #                        #   #   #                   #
#     ########################################             #
#                                            #             #
#                                                          #
#                              #        #      #############
############################   #        #                  #
#                 #            #        ################   #
#                 #            ######   #        #         #
#                 #############         #      #############
###############   #           #         #                  #
#     #                       #         ################   #
#     #                       ####      #                  #
#                                       #      #############
#################################       #                  #
#                                       ################   #
#     #    ##########       ############             #### ##
#     #            #####        #            #       #    ##
#     #     ###     #   ####    #         #  #       ####  #
#     #       #            #    #          #    #    #     #
#     ################### ##################    #    # #####
#     #                   ##################     ###       #
#     #   ##################     #   #   #                 #
#     #                        #   #   #                   #
#     ########################################             #
#                                            #             #
#                                                          #
#                              #        ####################
############################   #        #                  #
#                 #            #        ################   #
#                 #            ######   #                  #
#                 # ###########         #      #############
###############   #           #         #                  #
#     #                       #         ################   #
#     #                       ####      #                  #
#                             #         #      #############
####### #########################       #                  #
#     #                                 ################   #
#     #    ##########       ############             #### ##
#     #            #####        #            #       #    ##
#     #     ###     #   ####    #         #  #       ####  #
#     #       #            #    #          #    #    #     #
#     ################### ##################    #    # #####
#     #                   ##################     ###       #
#     #   ##################     #   #   #                 #
#     #                        #   #   #                   #
#     ########################################             #
#                                            #             #
#                                                          #
############################################################