############################################################
#                              #        #                  #
############################   #        #                  #
#                 #            #        #                  #
#                 #            ######   #                  #
#                 #      ######         #                  #
###############   #           #         #                  #
#     #                       #         #                  #
#     #                       ####      #                  #
#                                       #                  #
#################################                          #
#                                                          #
#                                 ##########################
#                                                     #    #
#                                                     #    #
#                                                     #    #
#                                                     #    #
#                                                          #
#                                                          #
#                                                          #
#                                                          #
#                                                          #
############################################################