#####################################################################################################################
#########################################################  ##########################################################
########################################################   ##########################################################
#######################################################     #########################################################
######################################################       ########################################################
#####################################################    #    #######################################################
##################   ################################   ###    ######################################################
#################     ##############################   #####   ######################################################
################       ############################    #####    #####################################################
################        ##########################    #######    ####################################################
################         ########################    #########    ###################################################
#################        ########################   ###########    ##################################################
#################        #######################    ####  ######   ##################################################
##################     ########################    ####    #####    #################################################
#####################  #######################    ####      #####    ################################################
#####################  ######################    ####        #####    ###############################################
#####################  ######################   #####        ######   ###############################################
#####################  #####################    ####    #     ######   ##############################################
#####################  ####################    ####    ## #    #####    #############################################
#####################  ###################    ####    ### ##    #####    ############################################
#####################  ##################    ####    #### ###    #####    ###########################################
###################### ##################   #####   ##### ####    #####   ###########################################
###################### #################    ####    #####  ###    #####    ##########################################
#####################  ################    ####    #####   ####    #####    #########################################
##################### ################    ####    #####     ####    #####    ########################################
#####                                    ####    #####       ####    #####                                     ######
####                                    ####    #####    #    ####    #####                                    ######
####                                    ####    #####   ###   #####   #####                                    ######
#####    ##################################    #####    ###    ####    ###################################    #######
######    ################################    #####    #####    ####    #################################    ########
#######   #####                              #####    #######    ####                              ######   #########
#######    ###                              ######   #########   #####                              ####    #########
########    ##                             ######    #########    #####                             ###    ##########
#########    ##    #############################    ###########    ############################    ###    ###########
##########   ###   ############################    #############    ###########################   ####    ###########
##########    ##    ###########################   ###############    #########################    ###    ############
###########    ##    ######                       ###############                       #####    ###    #############
############    ##    #####                      ######## ########                      #####   ####   ##############
############    ###   ######                    ########   ########                    #####    ###    ##############
#############    ##    #####    #######################     #######################    ####    ###    ###############
##############    ##    #####    ######################      ######################   ####    ###    ################
###############   ###   ######   #####################   #   #####################   #####   ####   #################
###############    ##    #####    ###################    #    ###################    ####    ###    #################
################    ##    #####    ###########          ###          ############   ####    ###    ##################
#################    ##    #####   ##########          #####          ##########   ####    ###    ###################
##################   ###   #####    #########          #####          #########    ####   ####   ####################
##################    ##    #####    #########   #### #####  #####   #########    ####    ###    ####################
###################    ##    #####   #########    ###  ###  #####    #########   ####    ###    #####################
####################    ##    ####    #########   ####  ## ######   #########    ####   ###    ######################
#####################   ###   #####    ########    ####    #####    ########    ####   ####   #######################
####################    ###   ######   #########   #####   #####   #########   #####   ####    ######################
###################    ###    ######   #########   #####   #####   #########   #####    ####    #####################
##################    ###    ######    #########   #############    ########    #####    ####    ####################
##################   ###    ######    #########   ###############   #########    #####    ####   ####################
#################    ###   #######   #########    ###############    #########   ######   ####    ###################
################    ###    ######    #########   #################   #########    #####    ####    ##################
###############    ###    ######    #########          #####          #########    #####    ####    #################
###############    ###   #######   ##########          #####          ##########   ######    ####   #################
##############    ###    ######    ###########          ###          ###########    ######   ####    ################
#############    ###    ######    ###################    #    ###################    #####    ####    ###############
#############   ###    #######   #####################   #   #####################   ######    ####    ##############
############    ###   #######    #####################       ######################   ######   ####    ##############
###########    ###    ######    #######################     #######################    #####    ####    #############
##########    ###    #######                    ########   ########                    ######    ####    ############
##########   ###    #######                      ########  #######                      ######    ####   ############
#########    ###   ########                       ######## #######                      #######   ####    ###########
########    ###    ###########################    ######## ######    ##########################    ####    ##########
#######    ###                             ####    ######  #####    ###                             ####    #########
#######   ####                              ####    ##### #####    ###                              #####   #########
######    #####                              ####    #### ####    ###                              ######    ########
#####    #################################    ####   #### ####    ##    ####### ##########################    #######
####                                   ####    ###    ### ###    ##    #####                                   ######
####                                    ####   ####    ## ##    ###   #####                                    ######
####                                     ###    ####    # #    ###    ####                                     ######
######################################    ###    ####   # #   ###    ####    ########################################
#######################################    ###    ###         ##    ####    #########################################
########################################    ###    ###       ##    #####   ##########################################
#########################################   ####    ###     ##    #####   ###########################################
#########################################    ####   ####   ###    ####    ###########################################
##########################################    ###    ###   ##    ####    ############################################
###########################################    ###    ######    ####    #############################################
############################################    ###    ####    #####   ##############################################
#############################################   ####    ##    #####    ##############################################
#############################################    ####   ##   #####    ###############################################
##############################################    ###        ####    ################################################
###############################################    ###      ####    #################################################
################################################   ####    #####   ##################################################
#################################################   ####  #####    ##################################################
#################################################    #########    ###################################################
##################################################    #######    ####################################################
###################################################    #####    #####################################################
####################################################   #####   ######################################################
####################################################    ###    ######################################################
#####################################################    #    #######################################################
######################################################       ########################################################
#######################################################     #########################################################
########################################################   ##########################################################
########################################################   ##########################################################
#####################################################################################################################
